                                                            
                                                            
                                                            
                                                            
                                                            
               ## #                                         
               #######                                      
               #######                                      
               ##                                           
              ####                                          
               ##                  ###                      
               ###                  ##  #                   
              #                   ######        #    #      
       #                          ######        #######     
    ######                        # ##          #######     
    #######                         ###         ######      
    ##  # #    # #                              ######      
    ###        #####                            ######      
    ## ........####                            #######      
    ## .      .#####                           #######S     
      #.      .#                                ######.     
      ..      ...                           ...........     
      .         .                          ..               
      .         .                         ..                
      .         ..                       ..                 
      .          ..                    ...                  
   ....           ..                 ...#                   
   .#########      .........         .####                  
   .########            # #....     ..#####                 
   .##    ##            ######.     .#####                  
   .##                  ######.     . ####                  
   .##                  ######.     . ####                  
   .###                 ######.......#####                  
   .##                 ########.                            
   .##                  ######                              
   .F                   ######                              
                        ######                              
                            ##                              
                                                            
                                                            